3 13 31
###############################
#p   ** **    *   2          1#
# # # #*# # # # # # # # # # # #
#*     ** * *  *   * ** 3 *   #
# # # # # #*# # # # # # #*# # #
#*   *s*    *** * x **       2#
# # # # # # # # # # # # # #*# #
#    *   2 *     1  *    **  3#
# #*# # #*#*#*#*# # #1# # #*# #
#      2 *   *2*    *   *     #
#*# # # # # # # # # # #*# # #*#
# *   1* **    ** ***     1   #
###############################