4 13 31
###############################
#p    * **    *   3   4       #
# # # #*# # # # # # # # # # # #
# 3    ** * *  *   * ** 3 *   #
# # # # # #*# # # # # # #*# # #
#*   * *    *b* *   **        #
# # # # # # # # # # # # # #*# #
# 2  *     * 1      *    **  3#
# #*# # #*#*#*#*# # #1# # #*# #
#    3   * 4 *2*    *   * 1   #
#*# # # # # # # # # # #*# # #*#
#x*  1 * **  1 ** ***     1   #
###############################