5 13 31
###############################
#p * *3  1    *  ** * *      *#
# # # # #*# # #*# # # # # #*# #
#  2 * * *** **  5   *    **  #
# #*# # # # #4# #b#1# # # # #*#
#        4 *     **      *  **#
# # #*# # # # # #*#*#*#*# # # #
#   *    4   *   * *x* *   4  #
# # # # #*# # # # # # #*# #*# #
#   ****         *2        5  #
# # # # # # # # # #*# # # # #*#
#  ** *5  *    2     4     3  #
###############################